{
  "df_target_to_id": {
    "%F277": 0,
    "%F279": 1,
    "%F280": 2,
    "%F276": 3,
    "%F281": 4,
    "%F278": 5,
    "%F324": 6,
    "%F511": 7,
    "%F516": 8,
    "%F513": 9,
    "%F508": 10,
    "%F462": 11,
    "%F478": 12,
    "%F476": 13,
    "%F512": 14,
    "%F483": 15,
    "%F479": 16,
    "%F484": 17,
    "%F487": 18,
    "%F493": 19,
    "%F490": 20,
    "%F492": 21,
    "%F498": 22,
    "%F481": 23,
    "%F496": 24,
    "%F397": 25,
    "%F520": 26,
    "%F521": 27,
    "%F515": 28,
    "%F336": 29
  }
}